refuge: (a place that gives) protection or shelter from danger, trouble, unhappiness, etc..; haven.
underclothes: clothes worn next to the skin, under other clothes; underwear; undergarment.
humbly: in a way that shows that you do not think you are important; humility.
evade: escape physically.
Herald: proclaiming.
exorcism: kicking evil spirits.
introvert: a person who is shy or don't like to talk to people in public. 
haired: got work or employed 
garment: a piece of clothing cloth
elegant: nice-looking, fashionable
edible: suitable or safe for eating; eatable.
slaughter: killing.
gratitude: the feeling or quality of being grateful; thankfulness; thanksgiving.
swift: happening or moving quickly or within a short time, especially in a smooth and easy way; rapid; fast.
inspection: scanning like those who are in the borders of some countries.
obligation: something that you must do; duty; commitment.
evacuate: to move people from a dangerous place to somewhere safe; transition.
concatenation: a series of events, ideas, or things that are connected; sequence.
impurity: the fact that a substance is dirty or lower in quality because it is mixed with another substance, or something that causes this; dirtiness.
tightly: firmly or closely; tautly.
rigid: stiff or fixed; not able to be bent or moved; stiff; solid; hard.
pure: not mixed with another chemical, unmixed.
wealthy: rich.
combustion: burning
bet: the gambling which occurs when people put money on expecting thing that is either will it happen or not, usually, people use it instead of expecting.
sphere: cover like a hemisphere 
stammer: misspelling or stumbling while talking. kinda 
corrupted: stopped working because of some damage mostly
sentimental: giving too much importance to emotions, especially love or sadness; aura.
persuade: convince
consequence: negative results
preceded: came before; precede 
column: vertical part of the chart 
allergy: sensitivity to some chemical compounds.
conference: An event for discussion about a political subject or scientific subject; congress
retreat: to go away from a place or person in order to escape from fighting or danger; undo; retract; withdraw; back up.
wounded: injured
contrary: opposite against 
aunt: any uncle from your father
devastating: destructive
dry: After I took a shower, I dried my hair.
concede: undoing from a battle; retreat 
altitude: depth
fleet: navy, a group of military ships 
contract: shrink, getting smaller, or a convince which means a written agreement especially concerning employment 
Shake: to move backwards and forwards or up and down in quick, short movements, or to make something or someone do this; vibrate or tremble
ecstasy: extreme happiness, temporal happiness
overflow: intensively flowing
bitter: tastes no good; opposite of sweet
Agriculture: farming 
avalanche: colossal parts of snow fallen from a mountain 
ironically: ridiculously; in a sarcastic way 
Hippopotamus: (frs alnhr).
mandatory: forcibly or should be done.
last: the most recent 
pot: a container for the food.
spoon: the tool which we use to eat.
polite: respectfully; gently 
stealth: sneak; enters quietly without getting noticed.
compensation: Paying back from an insurance 
pour: putting the liquid from one container to another; decant;  flow.
attorney: a paid person which defends either the victim or the suspected person; lawyer.
method: the traditional way of doing things 
patio: courtyard; an unroofed area that is completely or mostly enclosed by the walls of a large building.
embrace: hug, or adopt, or accept.
merge: fusion;  incorporate; becoming a one. 
guilty: culpable(deserved to blame) of doing specified wrongdoing(sin); blameworthy.
priest: a person who claims to have an ability or a direct connection with devils or god makes him capable of predicting the future.  
dissect: methodically cut up (a body, part, or plant) to study its internal parts; anatomize. 
vulnerable: resistless; susceptible(exposed) to physical or emotional attack or harm.
culprit: criminal; someone who has broken the law.
recruit: enlist (someone) in the armed forces.
comprise: including; involving; consist of; be made up of; to be the parts or members of something; to make up something.
marching: walking
forego: precede.
frontier: borders; 
supersede: take the place of (a person or thing previously in authority or use); supplant.
metaphor: Imaginative description; not real description.
funds: finance; a sum of money saved or made available for a particular purpose; reserve.
faggot: gay
hypothesize: assume; put (something) forward as a hypothesis.
idiocy: stupidity; a society or group that is controlled by or consists of people of low intelligence.
Truancy: evading from school; absenteeism.
stipend: annual income/revenue.
vanish:  (ي  ت   ل  ا ش    ى  ) fade away.
mountainside: the sloping surface of a mountain.
eggplant: ( ب     ا   ذ   ن  ج  ا  ن   )
munition: a supply or quantity of bullets and shells; ammunition.
mop: wipe.
mow: (جز) cut down (an area of grass) with a machine.
surpass: coming in front of people whether if it was in a business or real-life; override; bypass; exceed.
excruciating: painful
protest: (احتجاج) a strong complaint expressing disagreement, disapproval, or opposition.
grief: great sadness
Transcendental: relating to a spiritual or nonphysical realm.
stain: (ملطخ) mixed with something (commonly with liquid); blemish.
trench: (خندق) a deep hole dug by soldiers and used as a place from which they can attack the enemy while being hidden; foxhole.
brand: a type of product made by a particular company and sold under a particular name; maker.
trademark: a name or symbol on a product that shows it was made by a particular company, and that it cannot be used by other companies without permission; logo.
campaign: (حملة). an organized course of action to achieve a goal; group of people who have the same will attempting to achieve what they want; push; crusade; promotion(ترويج).
generosity: a willingness to give help or support, esp. more than is usual or expected; 
genuine: If people or emotions are genuine, they are honest and sincere; real; genuine; authentic; honest-to-goodness.
prohibit: to officially refuse to allow something; formally forbid (something) by law, rule, or other authority (سلطة); forbid; prevent.
Negate: to cause something to have no effect; nullify; ينفي.
emulsify: make into or become an emulsion.
Intermittent: choppy
mandible: the jaw or a jawbone, especially the lower jawbone in mammals and fishes.
lay: put down, especially gently or carefully. 
confiscate: (يصادر) to take a possession away from someone when you have the right to do so, usually as a punishment and often for a limited period, after which it is returned to the owner. 
deceive: trick, manipulate; to trick somebody.
dominate: control over something.
emerge: move out of or away from something and come into view; appear; come out.
artillery: Large cannon-like weapons, transportable and usually operated by more than one person.
hiccups: (فواق) a loud noise that you make in the throat without wanting to, caused by a sudden tightening of a muscle just below the chest and usually happening repeatedly.
catastrophe: an event causing great and often sudden damage or suffering; a disaster; tragedy.
skewed: suddenly change direction or position.
Invade: (of an armed force or its commander) enter (a country or region) to subjugate or occupy it. (يغزو)
gelatinous: (هلامي) having the consistency of jelly; sticky.
inhale: the opposite of exhaling, which is absorbing air.
innate: An innate quality or ability is one that you were born with, not one you have learned (ف  ط  ر  ة ).
fissure: crack; a long, narrow opening or line of breakage made by cracking or splitting, especially in rock or earth.
coy: (especially about a woman) making a pretense of shyness or modesty that is intended to be alluring(attractive)
endorsement: an act of giving one's public approval or support to someone or something.
preserve: maintain (something) in its original or existing state; conserve.
exiled: (of a person) having been expelled and barred from one's native country, typically for political or punitive(in a punishing way) reasons.
rouse: bring out of sleep; awaken.
arouse: evoke or awaken (a feeling, emotion, or response).
plucked: take hold of (something) and quickly remove it from its place; pick off.
throne: a ceremonial(festive) chair for a sovereign(who has the royalty), bishop, or similar figure.
thee: archaic or dialect(an accent) form of you, as the singular object of a verb or preposition.
consecrated: made holy; hallowed; sanctified.
gullible: easily persuaded to believe something; credulous; easy to deceive; foolish
unkindled: impolite.
turbulent: violent or naughty
treason: betrayal.
conquer: overcome and take control of (a place or people) by use of military force.
smirking: smiling in an irritatingly smug; conceited(arrogance; cocky), or silly way.
abyss: a deep or seemingly bottomless chasm(hole); fissure.
condolence: an expression of sympathy, especially on the occasion of a death.
prostrate: lying stretched out on the ground with one's face downward.
prior: existing or happening before something else, or before a particular time; before; afore.
endorsed: declare(announce) one's public approval or support of.
minister: a member of the government in Britain and many other countries who is in charge of a particular department or has an important position in it.
provocation: synonymous harassment
sterilized: made free from bacteria or other living microorganisms(very tiny organisms)
imitation: faking or simulating 
harbor: a place on the coast where vessels(boats) may find shelter(refuge), especially one protected from rough water bt piers( a part of the road which usually in front of the supermarkets), jetties, and other artificial structures 
discrepancy: a difference between two things that should be the same; contradiction 
exposure: the fact of experiencing something or being affected by it because of being in a particular situation or place.
impose: to force someone to accept something, especially a belief or way of living.
extinct: not now existing.
privileges: an advantage that only one person or group of people has, usually because of their position or because they are rich; prerogative.
exert: to cause yourself to make an effort; exercise.
carving: a shape or pattern cut into wood or stone or the skill of doing this; engraving. 
improvisation: doing something that is not written in the scene before or not planned in a movie for example
savvy: intelligently.
endure: bear.
liability: responsibility. 
hypocrite: hiding things on people that you're believing in. And claiming that you did another thing although you weren't. 
tremendous:  meaning, extremely big amount, or scale of something or intensity of it; enormous; massive; immense.
colossal: gigantic. meaning, extremely large 
fraction: section, part of something.
revenue: income. 
capitulate: surrender
annihilation: extermination. Meaning, Killing on a wide range; (ex global annihilation)
commendation: praise 
irritating: making you feel annoyed or angry; annoying; bothersome; troublesome; disturbing.
suffocating: throttling. 
village: smaller than a city. 
siege: a state which military operation when the enemy forces surround a town or building or a village or an entire city. 
Brushing: cleaning his/her teeth using a toothbrush
miserable: An intense level of sadness, or dispiritedness, helpless
sanctify: consecrate, hallow. setting something to be holy.
shave: removing hair.
defective: having a flaw, flawed.
threshold: the beginning of something.
occasional:  from time to time non-sequential.
orphanage: a place where people who don't have their real parents alive get raised(bred).
sturdy: physically strong and solid or thick, and therefore unlikely to break or be hurt; tough.
blunt: to make a feeling less strong; to make something less sharp.
liberty: freedom.
sweater: big hoodies like jackets.
cruel: harsh
clues: pieces/shreds of evidence. 
reliant: relaying/depending on something.
tale: an ancient story 
segregate: separate or isolate.
escort: going with, accompany.
midget: extremely short; elf; dwarf.
Sedition: a problem caused by someone or some people working on it deliberately to make things go to their side 
clue: an idea.
antagonist: the opposite of the protagonist, which is an enemy in a comic series or anime etc...
rigged: faked.
auxiliary: helper.
exhibit: shows.
compilations: collection.
Constitution: rules of a country (دستور).
raw: fresh.
commitment: like a promise that you'll never do something or never stop doing it; pledge; undertaking; solemn promise.
horde: the small social group consists mostly of 5 families 
lung: One of the major parts of the respiratory system.
sufficient: enough for a particular purpose ;enough, adequate.
slang: very informal language that is usually spoken rather than written, used especially by particular groups of people; informal.
condescending: a feeling of superiority over average people. 
shove: to push someone or something forcefully; push.
piercing: sharp, we use it mostly for mental attributes.  e.g piercing visionary, piercing analysis.
Fossils: organism buried for a great amount of time until it turned into a whole another. 
impress: to make someone feel admiration. 
disregarded: from disregard which means paying no attention to; ignore; neglect.
remarkably: in a way that attracted attention.
treatment: curing with using medicine; cure.
fog: a weather condition in which very small drops of water come together to form a thick cloud close to the land or sea, making it difficult to see; mist; vapor.
sublimation: the opposite of deposition; where the substance turns converts by the heat (directly) from solid-state to gas state.
attribute: referring to, or trait (feature).
sour: tastes like an acid.
impairment: weakness from medical aspect. 
Compound sentence: noun acts as an adjective; describes the noun that was before it
tidings: e.g prophet Moses has told Pharaoh tiding that they are going to drown in their river (Nile river) while chasing him and his folk.
sewing: the craft were clothes made from; needlework.
salary: the revenue(income) which an employee gets per month.
myth: a legend of something that claimed to exist several centuries in the past.
Submarine: the diving ship which dives in the deep oceans.
abide: Following a system whether if it was a government or constitution; obey; comply.
cast: throw away.
Regiment: a crowd of military soldiers; troop. 
lullaby: a quiet, gentle song sung to send a child to sleep; soothing song.
discipline: correction; the practice of obeying(abiding) to the rules.
battalions: Regiment; A group of a permanent unit of an army commanded by a colonel and divided into several companies, squadrons.
Easygoing: tolerant; easily forgive someone for doing a sin for example  
devour: prey on; when a predator attacks its prey.
glow: flare; the act of shining.
piss: peeing for a while; going to the bathroom, e.g Imma taking a piss.
Ambidextrous: both-handed.
dermatologist: A person who studies skin-related diseases; skilled in dermatology.
epilepsy: a neurological disorder marked by sudden recurrent episodes of sensory disturbance, loss of consciousness, or convulsions, associated with abnormal electrical activity in the brain.
disoriented: confused. 
recurrent: frequent. 
thoroughly: carefully.
steady: stable; constant.
perilous: risky; chancy.
retrain: going back to a certain stage in school to learn some skills again. 
tedious: too long, slow, or dull; tiresome or monotonous; uninteresting; boring.
gore: blood.
constituent: component. 
dilute: lower(verb).
depravity: moral corruption; wickedness.
deceptive: maniuplative.
decisive: settling an issue; producing a definite(confirmed) result; crucial.
authority: س  ل ط  ة.
Glistening: shining with a sparkling light; shimmering; sparkling; gleamy; glittering.
shore: a beach.
outcast: abandoned or deserted; forsaken; castaway.
intricate: very complicated or detailed.
plead: make an emotional appeal.
scaffold: a raised wooden platform used formerly(in the past) for the public execution of criminals.
spectacular: beautiful in a dramatic and eye-catching way; amazing.
staggering: deeply shocking; astonishing; astounding.
squandered: waste (something, especially money or time) recklessly and foolishly.
ambush: a surprise attack by people lying in wait in a concealed(hidden) position.
saliva: (لعاب) the liquid produced in your mouth to keep the mouth wet and to help to prepare food to be digested; mouthwater.
formerly: previously. 
grind: crush.
contrasting: Negates with the previous point; conflict.
revolt: ت  م  ر د  rise in rebellion; revolution.
bombardment: pounding.
sinking: drowning.
sesquipedalian: (of a word) polysyllabic; long.
incline: tend to; descend.
tangible: tactile; possible to touch.
meritless: undeserved.
sentient: able to perceive or feel things.
penetrable: able to get pierced; allowing things to pass through; permeable.
surfer: a person who browses on the internet.
miracle: miraculous, miraculously; supernatural phenomenon; prodigy
breakthrough: a sudden, dramatic, and important discovery or development.
epitomized: be a perfect example of.
reluctant: unwilling and hesitant; disinclined.
agitated: feeling or appearing troubled or nervous.
bargaining: negotiate the terms and conditions of a transaction.
longitudinal: running lengthwise rather than across.
alacrity: speed and eagerness; readiness; ardour; fervour/fervor.
diffident: Lacking self-confidence; timid; modest.
williwaw: a sudden violent squall blowing offshore from a mountainous coast.
ungainly: awkward and without grace (= moving smoothly and attractively) in movement; clumsy.
abhor: regard with disgust and hatred; loathe.
coerce: force; compel; oblige; persuade (an unwilling person) to do something by using force or threats.
expunge: erase or remove completely (something unwanted or unpleasant).
attitudinize: adopt or express a particular attitude or attitudes, typically just for effect.
replete: filled or well-supplied with something.
egregious: outstandingly bad; shocking.
abomination: a thing that causes disgust or hatred; atrocity
disgrace: dishonor; shame; loss of reputation or respect as the result of a dishonorable action.
prevaricate: speak or act in an evasive way.
expiate: atone(make amends or reparation) for (guilt or sin).
picayune: triviality; lack of seriousness or importance; insignificance.
indolent: showing no real interest or effort; lazy.
indefatigable: Extremely persistent and untiring; tireless.
meretricious: apparently attractive but having, in reality, no value or integrity; tawdrily and falsely attractive.
variety: diversity.
percussion:  a method of tapping bo liability imposed on others; relief.
flu: short for influenza.
implicate: show (someone) to be involved in a crime.
bereavement: the state of being sad because a family member or friend has recently died.
etymological: relating to the origin and historical development of words and their meanings.
altruistic: showing a disinterested and selfless concern for the well-being of others; unselfish.
indispensable: necessary. 
unanimous: If a group of people are unanimous, they all agree about one particular matter or vote the same way, and if a decision or judgment is unanimous, it is formed or supported by everyone in a group; united.
reminiscence: a story told about a past event remembered by the narrator(a person who narrates something, especially a character who recounts the events of a novel or narrative poem).
mischievous: (of a person, animal, or their behavior) causing or showing a fondness for playfully causing trouble.
miscellaneous: (of items or people gathered or considered together) of various types or from different sources; variety.
gauge: a device for measuring the amount or size of something; to calculate an amount, especially by using a measuring device; scale.
strenuous: needing or using a lot of physical or mental effort or energy; arduous.
personnel: people employed in an organization or engaged in an organized undertaking such as military service; staff.
maneuver: (مناورة) a movement or series of moves requiring skill and care.
silhouette: the dark shape and outline of someone or something visible against a lighter background, especially in dim light.
exuberant: filled with or characterized by a lively energy and excitement.
condescend: show feelings of superiority; be patronizing.
grievous: (of something bad) very severe or serious.
simultaneous: occurring, operating, or done at the same time.
courtesy: the showing of politeness in one's attitude and behavior toward others. courteous is merely and etymologically quoted from it
conceive: form or devise (a plan or idea) in the mind.
conscientious: (of a person) wishing to do what is right, especially to do one's work or duty well and thoroughly.
susceptible: likely or liable to be influenced or harmed by a particular thing.
acquaintance: a person's knowledge or experience of something.
jewelry: personal ornaments, such as necklaces ( ق ل  ا د ة  ), rings, or bracelets ( ا س   ا و  ر ), that are typically made from or contain jewels and precious metal.
minuscule: extremely small; tiny.
condemn: express complete disapproval of, typically in public; censure.
guerrilla: gangsters warfare.
hypocrisy: hypocrite shows the practice of claiming to have moral standards or beliefs to which one's own behavior does not conform; pretense.
idiosyncrasy: a mode of behavior or way of thought peculiar to an individual.
liaison: communication between people or groups who work with each other; communication.
resemblance: the state of resembling or being alike; similarity.
dilemma: a situation in which a difficult choice has to be made between two or more alternatives, especially equally undesirable ones.
prescription: an instruction written by a medical practitioner that authorizes a patient to be provided a medicine or treatment.
imbroglio: an extremely confused, complicated, or embarrassing situation.
embroilment: the noun of implicated. 
berate: scold or criticize (someone) angrily; vituperate insanely; rebuke.
nonchalant: (of a person or manner) feeling or appearing casually calm and relaxed; not displaying anxiety, interest, or enthusiasm; careless
decimated: kill, destroy, or remove a large percentage or part of.
hoard: a stock or store of money or valued objects, typically one that is secret or carefully guarded.
malodorous: smelling bad; having a bad odor.
odious: extremely unpleasant; repulsive.
droll: humorous; curious or unusual in a way that provokes dry amusement. 
posh: (informal) elegant or stylishly luxurious.
invigorate: energize
querulous: complaining in a petulant or whining manner.
puerile: childish
opulent: ostentatiously rich and luxurious or lavish.
lucid: expressed clearly; easy to understand.
ingenuity: the quality of being clever, original, and inventive.
repine: feel or express discontent; fret; complain.
futile: incapable of producing any useful result; pointless.
haughty: arrogantly superior and disdainful.
quell: put an end to (a rebellion or other disorder), typically by the use of force.
captivated: attract and hold the interest and attention of; charm.
voyage: a long journey involving travel by sea or in space.
refrigerator: fridge. 
canvas: a strong, coarse unbleached cloth made from hemp, flax, cotton, or similar yarn, used to make items such as sails and tents and as a surface for oil painting.
skyline: an outline of land and buildings defined against the sky.
principal: first in order of importance; main.
amateur: a person who engages in a pursuit, especially a sport, on an unpaid rather than a professional basis.
prerogative: a right or privilege exclusive to a particular individual or class.
accommodate: (of physical space, especially a building) provide lodging or sufficient space for; fit in with the wishes or needs of.
ribbon: a long, narrow stripe(tape).
obstreperous: noisy and difficult to control.
forfend: avert, keep away, or prevent (something evil or unpleasant).
forestall: prevent or obstruct (an anticipated event or action) by taking action ahead of time.
obviate: remove (a need or difficulty).
ideological: based on or relating to a system of ideas and ideals, especially concerning economic or political theory and policy. 
vendetta: a blood feud in which the family of a murdered person seeks vengeance on the murderer or the murderer's family.
purloin: steal (something).
filch: an informal word that means pilfer or steal (something, especially a thing of small value) in a casual way.
hoosegow: US a slang word for jail.
minatory: expressing or conveying a threat; threatening.
bogart: (transitive) slang; to monopolize or keep (something, esp a marijuana cigarette) to oneself selfishly; hector.  
doppelganger: a spirit that looks exactly like a living person, or someone who looks exactly like someone else but who is not related to that person.
implicit: implied though not plainly expressed; implied.
revelry: lively and noisy festivities, especially when these involve drinking a large amount of alcohol.
evokes: bring or recall to the conscious mind, invoke (a spirit or deity).
eccentricity: the quality of being eccentric( Being odd)
mastery: control or superiority over someone or something.
urge: try earnestly(seriously) or persistently to persuade (someone) to do something.
attained: succeed in achieving (something that one desires and has worked for).
relegated: consign or dismiss to an inferior rank or position.
consign: deliver (something) to a person's custody, typically for it to be sold.
apprehend: to catch and arrest someone who has not obeyed the law; arrest.
relentless: oppressively constant; incessant.
traipse: (informal) walk or move wearily or reluctantly.
eligible: having the right to do or obtain something; satisfying the appropriate conditions.
cliche: an idea or expression that has been used too often and is often considered a sign of bad writing or old-fashioned thinking.
intransigent: unwilling or refusing to change one's views or to agree about something.
protracted: lasting for a long time or longer than expected or usual.
ruckus: a disturbance or commotion.
propensity: the fact that someone is likely to behave in a particular way, especially a bad way.
assail: make a concerted or violent attack on.
consensus: a general agreement.
consecutive: following continuously; successive.
conflagration: an extensive fire which destroys a great deal of land or property; Conflict; dispute.
caesura: (in Greek and Latin verse) a break between words within a metrical foot.
assimilate: to take in and make a part of your basic knowledge something learned from others, so that you can use it as your own.
asinine: extremely stupid or foolish.
duplicity: deceitfulness; double-dealing. dishonesty; hypocrisy.
countenance: a person's face or facial expression.
illicit: forbidden by law, rules, or custom; illegitimate.
scrutinize: examine or inspect closely and thoroughly.
prevail: prove more powerful than opposing forces; be victorious.
angst: a feeling of deep anxiety or dread, typically an unfocused one about the human condition or the state of the world in general.
voluptuous: sensual; curvaceous and sexually attractive (typically used of a woman).
parochial: relating to a church parish.
pariah: an outcast.
aphorism: a pithy observation that contains a general truth, such as “if it ain't broke, don't fix it.”.
wary: feeling or showing caution about possible dangers or problems.
perspicacious: having a ready insight into and understanding of things.
paradigm: a typical example or pattern of something; a model.
aplomb: confidence and style.
voracious: wanting or devouring great quantities of food.
kettle: a container for boiling water, that has a lid, handle, and spout and is made from plastic or metal; boiler; teakittle.
swerve: change or cause to change direction abruptly.
fatuous: silly and pointless.
moss: a small flowerless green plant that lacks true roots, growing in damp habitats and reproducing through spores released from stalked capsules.
cantankerous: bad-tempered, argumentative, and uncooperative.
supercilious: behaving or looking as though one thinks one is superior to others.
acumen: the ability to make good judgments and quick decisions, typically in a particular domain.
calamity: an event causing great and often sudden damage or distress; a disaster.
camaraderie: a feeling of friendliness towards people that you work or share an experience with.
autochthonous: (of an inhabitant of a place) indigenous rather than descended from migrants or colonists.
aberration: a departure from what is normal, usual, or expected, typically one that is unwelcome.
acquiesce: accept something reluctantly but without protest.
perplex: (of something complicated or unaccountable) cause (someone) to feel completely baffled.
placate: make (someone) less angry or hostile.
transplant: to move something, or to be moved, from one place or person to another.
diarrhea: an illness in which the body's solid waste is more liquid than usual and comes out of the body more often. 
cognizant: understanding or realizing something.
redundant: more than what is usual or necessary, especially using extra words that mean the same thing; excessive
disperse: to spread across or move away over a large area, or to make something do this.
departure: going away; leaving.
prosecutor: a person, especially a public official, who  legal proceedings against someone.
intruder: someone who is in a place or situation where they are not wanted; perretain.
telepathic: supposedly capable of transmitting thoughts to other people and of knowing their thoughts; psychic.
aversion: a strong dislike or disinclination.
converse: engage in conversation.
worthwhile: worth the time, money, or effort spent; of value or importance.
Wig: a covering for the head made of real or artificial hair, typically worn by people for adornment or by people trying to conceal their baldness or in England by judges and barristers in courts of law.
impeccable: flawless.
laminate: overlay (a flat surface, especially paper) with a layer of plastic or some other protective material.
intriguing: arousing one's curiosity or interest; fascinating.
diminish: make or become less.
countermeasure: an action taken to counteract a danger or threat.
orchestrate: arrange or direct the elements of (a situation) to produce a desired effect, especially surreptitiously(stealthly).
acclaim: praise enthusiastically and publicly; cheer.
gesticulate: use gestures, especially dramatic ones, instead of speaking or to emphasize one's words.
patriarchy: a system of society or government in which the father or eldest male is head of the family and descent is traced through the male line.
proponent: a person who advocates a theory, proposal, or project.
accuse: a charge or claim that someone has done something illegal or wrong; indict; arraign; charge
dart: move or run somewhere suddenly or rapidly.
oppress: keep (someone) in subservience and hardship, especially by the unjust exercise of authority; persecute; abuse.
refute: prove (a statement or theory) to be wrong or false; disprove.
cloak: an outdoor overgarment, typically sleeveless, that hangs loosely from the shoulders; ma ntle.
subsidiary: less important than but related or supplementary to something.
startle: cause (a person or animal) to feel sudden shock or alarm.
cadet: a young trainee in the armed services or police force.
stroll:  walk in a leisurely(to walk in a slow relaxed way, especially for pleasure) way.
handkerchief: a square of cotton or other finely woven material, typically carried in one's pocket and intended for blowing or wiping one's nose; napkin.
embroider: decorate (cloth) by sewing patterns on it with thread.
mortify: cause (someone) to feel embarrassed, ashamed, or humiliated.
petrify: change (organic matter) into a stony concretion by encrusting or replacing its original substance with a calcareous, siliceous, or other mineral deposit.
stupefy: make (someone) unable to think or feel properly.
campus: the grounds and buildings of a university or college.
encrust: cover or decorate (something) with a hard surface layer.
Souvenir: a thing that is kept as a reminder of a person, place, or event.
probity: the quality of having strong moral principles; honesty and decency; virtuousness.
pidgin: a grammatically simplified form of a language, used for communication between people not sharing a common language. Pidgins have a limited vocabulary, some elements of which are taken from local languages, and are not native languages, but arise out of language contact between speakers of other languages.
retain: to keep or continue to have something.
hark: listen
confetti: small pieces of coloured paper that you throw at a celebration, especially over two people who have just been married.
Carmelite: a friar or nun of a contemplative Catholic order founded at Mount Carmel during the Crusades.
convent: a Christian community under monastic vows, especially one of nuns.
scold: remonstrate with or rebuke (someone) angrily.
palace: the official residence of a sovereign, archbishop, bishop, or other exalted person.
lure: tempt (a person or animal) to do something or to go somewhere, especially by offering some form of reward.
confide: tell someone about a secret or private matter while trusting them not to repeat it to others.
offspring: a person's child or children.
admission: the process or fact of entering or being allowed to enter a place, organization, or institution.
dexterity: skill in performing tasks, especially with the hands.
fastidious: very attentive to and concerned about accuracy and detail; picky.
scoundrel: a dishonest or unscrupulous person; a rogue.
traduce: speak badly of or tell lies about (someone) so as to damage their reputation.
stud: a large-headed piece of metal that pierces and projects from a surface, especially for decoration.
shrimp: a small free-swimming crustacean(ق ش   ري  ات  ) with an elongated body, typically marine and frequently harvested for food.
prosecute: institute legal proceedings against (a person or organization); sue.
persecute: subject (someone) to hostility and ill-treatment, especially because of their race or political or religious beliefs.
humiliate: make (someone) feel ashamed and foolish by injuring their dignity and self-respect, especially publicly.
deploy: move (troops or equipment) into position for military action.
incite: encourage or stir up (violent or unlawful behavior); provoke.
sobbed: cry noisily, making loud, vermilionlies  gasps.
tremulous: shaking or quivering slightly.
blaze: burn fiercely or brightly(whether if it was metaphorical or realistic).
premeditate: think out or plan (an action, especially a crime) beforehand.
saddle: put a saddle on (a horse).
altar: the table in a Christian church at which the bread and wine are consecrated in communion services.
corridor: a long passage in a building or train, especially with rooms on either side.
bribe: persuade (someone) to act in one's favor, typically illegally or dishonestly, by a gift of money or other inducement.
mucus: a slimy substance, typically not miscible with water, secreted by mucous membranes and glands for lubrication, protection, etc.
hedgehog: a small nocturnal Old World mammal with a spiny coat and short legs, able to roll itself into a ball for defense.
cucumber: a long, green-skinned fruit with watery flesh, usually eaten raw in salads or pickled.
seesaw: a long plank balanced in the middle on a fixed support, on each end of which children sit and swing up and down by pushing the ground alternately with their feet.
vase: a decorative container, typically made of glass or china and used as an ornament or for displaying cut flowers.
gear: one of a set of toothed wheels that work together to alter the relation between the speed of a driving mechanism (such as the engine of a vehicle or the crank of a bicycle) and the speed of the driven parts (the wheels).
ink: a colored fluid used for writing, drawing, printing, or duplicating.
rotten: corrupted
crocodile: a large predatory semiaquatic reptile with long jaws, long tail, short legs, and a horny textured skin, using submersion and stealth to approach prey unseen. The crocodile has been extensively hunted for its valuable skin.
cabbage: a cultivated plant eaten as a vegetable, having thick green or purple leaves surrounding a spherical heart or head of young leaves
lettuce: a cultivated plant of the daisy family, with edible leaves that are a usual ingredient of salads. Many varieties of lettuce have been developed with a range of form, texture, and color.
olive: a small oval fruit with a hard pit and bitter flesh, green when unripe and brownish black when ripe, used as food and as a source of oil.
referee: an official who watches a game or match closely to ensure that the rules are adhered to and (in some sports) to arbitrate on matters arising from the play.
friction: the resistance that one surface or object encounters when moving over another.
swamp: an area of low-lying, uncultivated ground where water collects; a bog or marsh.
crayon: a pencil or stick of colored chalk or wax, used for drawing.
socket: an electrical device receiving a plug or light bulb to make a connection.
postoffice: the public department or corporation responsible for mail services and (in some countries) telecommunications; the postal service.
lampshade: a cover for a lamp, used to soften or direct its light.
Cemetery: a burial ground; a graveyard.
commodity: a raw material or primary agricultural product that can be bought and sold, such as copper or coffee.
juridiction: the official power to make legal decisions and judgments.
cavendish: tobacco softened, sweetened, and formed into cakes.
grudge: a persistent feeling of ill will or resentment resulting from a past insult or injury.
eyelash: each of the short curved hairs growing on the edges of the eyelids, serving to protect the eyes from dust particles.
lid: a removable or hinged cover for the top of a container.
nausea: a feeling of sickness with an inclination to vomit.
wet: covered or saturated with water or another liquid;
mutate: change or cause to change in form or nature.
giraffe: a large African mammal with a very long neck and forelegs, having a coat patterned with brown patches separated by lighter lines. It is the tallest living animal.
tropical: from or relating to the area between the two tropics.
infallible: incapable of making mistakes or being wrong.
teetotalism: the approach of staying away from alcohol.
diligent: having or showing care and conscientiousness in one's work or duties; hard-working; assiduous; indusrious.
gecko: ( بريص , وزغة  ) a nocturnal and often highly vocal lizard which has adhesive pads on the feet to assist in climbing on smooth surfaces. It is widespread in warm regions.
diaper: a linen or cotton fabric woven in a repeating pattern of small diamonds.
articulate: (of a person or a person's words) having or showing the ability to speak fluently and coherently.
enunciate: say or pronounce clearly.
clerk: a person employed in an office or bank to keep records, accounts, and undertake other routine administrative duties.
premarital: occurring or existing before marriage.
polyglot: knowing or using several languages.
foreshadow: be a warning or indication of (a future event).
untenable: (especially of a position or view) not able to be maintained or defended against attack or objection.
posterior: positioned at or towards the back
ligaments: any of the strong strips of tissue in the body that connect various bones together, that limit movements in joints, and that support muscles and other tissue; joints.
reptile: a vertebrate animal of a class that includes snakes, lizards, crocodiles, turtles, and tortoises. They are distinguished by having a dry scaly skin and typically laying soft-shelled eggs on land.
pebble: a small stone made smooth and round by the action of water or sand.
tenacious: tending to keep a firm hold of something; clinging or adhering closely; stubborn; intansigent.
veterinary: relating to the diseases, injuries, and treatment of farm and domestic animals.
soothing: having a gently calming effect.
baggage: personal belongings packed in suitcases for traveling; luggage.
complicit: involved with others in an illegal activity or wrongdoing.
reiterate: say something again or a number of times, typically for emphasis or clarity; iterate; repeat.
lucrative: producing a great deal of profit; profitable; moneymaking.
penance: voluntary self-punishment inflicted as an outward expression of repentance for having done wrong.
continent: any of the world's main continuous expanses of land (Africa, Antarctica, Asia, Australia, Europe, North America, South America).
pedestrian: a person walking along a road or in a developed area; walker
cheetah: a large spotted cat found in Africa and parts of Asia. It is the fastest animal on land.
impersonate: pretend to be (another person) as entertainment or in order to deceive someone.
coddle: treat in an indulgent or overprotective way.
bagel: a dense bread roll in the shape of a ring, made by boiling dough and then baking it.
indulgent: having or indicating a tendency to be overly generous to or lenient with someone.
draughty: (of an enclosed space) cold and uncomfortable because of currents of cool air.
missus: a person's wife.
therein: in that place, document, or respect.
verdancy:  the lush appearance of flourishing vegetation. greenness, verdure. profuseness, profusion, richness, cornucopia - the property of being extremely abundant; "the profusion of detail"; "the idiomatic richness of English".
hangover: a severe headache or other after effects caused by drinking an excess of alcohol.
bloodshed: the killing or wounding of people, typically on a large scale during a conflict.
thereof: of the thing just mentioned; of that.
crowdfunding: the practice of funding a project or venture by raising many small amounts of money from a large number of people, typically via the internet.
nuance: a subtle difference in or shade of meaning, expression, or sound.
glib: (of words or the person speaking them) fluent and voluble but insincere and shallow.
swindle: use deception to deprive (someone) of money or possessions.
defraud: illegally obtain money from (someone) by deception.
apathy: lack of interest, enthusiasm, or concern.
zeitgeist: the defining spirit or mood of a particular period of history as shown by the ideas and beliefs of the time.
grapple: engage in a close fight or struggle without weapons; wrestle.
venturing: dare to do something or go somewhere that may be dangerous or unpleasant.
omission: a person or thing that has been left out or excluded.
rigorously: in an extremely thorough and careful way.
candour: the quality of being open and honest in expression; frankness.
ubiquitous: present, appearing, or found everywhere.
enfold: surround; envelop.
infringe: actively break the terms of (a law, agreement, etc.).
varmint: a troublesome and mischievous person, especially a child.
melancholy: a feeling of pensive sadness, typically with no obvious cause.
elicit: to get or produce something, especially information or a reaction.
obscene: (of the portrayal or description of sexual matters) offensive or disgusting by accepted standards of morality and decency.
unravel: undo (twisted, knitted, or woven threads). investigate and solve or explain (something complicated or puzzling).
urinate: pee; piss; piddle.
enervate: cause (someone) to feel drained of energy or vitality; weaken.
cynicism: an inclination to believe that people are motivated purely by self-interest; skepticism.
alleged: (of an incident or a person) said, without proof, to have taken place or to have a specified illegal or undesirable quality.
baptize: administer baptism to (someone); christen.
compost: decayed organic material used as a plant fertilizer.
moisten: wet slightly.
pedal: each of a pair of foot-operated levers used for powering a bicycle or other vehicle propelled by the legs.
propel: drive, push, or cause to move in a particular direction, typically forward.
delicate: very fine in texture or structure; of intricate workmanship or quality.
punctuate: insert punctuation marks in (text).
compliant: inclined to agree with others or obey rules, especially to an excessive degree; acquiescent.
shepherd: guide or direct in a particular direction.
assert: state a fact or belief confidently and forcefully.
adjust: alter or move (something) slightly in order to achieve the desired fit, appearance, or result.
regularize: to change a situation or system so that it obeys laws or is based on reason.
deaf: lacking the power of hearing or having impaired hearing.
coordinate: bring the different elements of (a complex activity or organization) into a relationship that will ensure efficiency or harmony.
barrage: a concentrated artillery bombardment over a wide area.
anchor: a heavy object attached to a rope or chain and used to moor a vessel to the sea bottom, typically one having a metal shank with a ring at one end for the rope and a pair of curved and/or barbed flukes at the other.
reich: Germany during the period of Nazi control from 1933 to 1945.
cabaret: entertainment held in a nightclub or restaurant while the audience eats or drinks at tables.
parsley: a biennial plant with white flowers and aromatic leaves that are either crinkly or flat and used as a culinary herb and for garnishing food.
rationale: a set of reasons or a logical basis for a course of action or a particular belief.
gurgle: make a hollow bubbling sound like that made by me rainbow six siege water running out of a bottle.
tramps: a person who travels from place to place on foot in search of work or as a vagrant or beggar.
goner: a person or thing that is doomed or cannot be saved.
ration: a fixed amount of a commodity officially allowed to each person during a time of shortage, as in wartime.
locust: a large and mainly tropical grasshopper with strong powers of flight. It is usually solitary, but from time to time there is a population explosion, and it migrates in vast swarms that cause extensive damage to crops.
forging: make or shape (a metal object) by heating it in a fire or furnace and beating or hammering it.
morale: the confidence, enthusiasm, and discipline of a person or group at a particular time.
subsistence: the action or fact of maintaining or supporting oneself at a minimum level.
massacre: an indiscriminate and brutal slaughter of people; butchery.
loaf: a quantity of bread that is shaped and baked in one piece and usually sliced before being eaten.
shivering: shaking slightly and uncontrollably as a result of being cold, frightened, or excited.
rack: a framework, typically with rails, bars, hooks, or pegs, for holding or storing things; shelf.
mustard: a pungent-tasting yellow or brown paste made from the crushed seeds of certain plants, typically eaten with meat or used as a cooking ingredient.
conspicuous: standing out so as to be clearly visible.
insist: demand something forcefully, not accepting refusal.
cinnamon: an aromatic spice made from the peeled, dried, and rolled bark of a Southeast Asian tree.
rant: speak or shout at length in a wild, impassioned way.
payroll: a list of a company's employees and the amount of money they are to be paid.
buffet: a meal consisting of several dishes from which guests serve themselves.
sober: make or become sober after drinking alcohol.
sadist: a person who derives pleasure, especially sexual gratification, from inflicting pain or humiliation on others.
derive: obtain something from (a specified source).
drunkard: a person who is habitually drunk.
swig: a large gulp of drink.
vintage: the year or place in which wine, especially wine of high quality, was produced.
ruffled: disarranged.
incentivized: provide (someone) with an incentive for doing something.
slumber: sleep.
stern: (of a person or their manner) serious and unrelenting, especially in the assertion of authority and exercise of discipline.
consternate: fill (someone) with anxiety.
behold: see or observe (a thing or person, especially a remarkable or impressive one).
vice: immoral or wicked behavior.
threescore: sixty
delectable: (of food or drink) delicious.
impede: delay or prevent (someone or something) by obstructing them; hinder.
revamp: give new and improved form, structure, or appearance to.
admonish: warn or reprimand someone firmly.
rib: each of a series of slender curved bones articulated in pairs to the spine (twelve pairs in humans), protecting the thoracic cavity and its organs.
hinder: delay or prevent (someone or something) by obstructing them; hinder.
pedigree: the record of descent of an animal, showing it to be purebred.
collide: hit with force when moving.
ruffian: a violent person, especially one involved in crime.
commence: begin; start; initiate.
divert: cause (someone or something) to change course or turn from one direction to another.
calisthenics: gymnastic exercises to achieve bodily fitness and grace of movement.
bleak: gloomy
prattle: talk at length in a foolish or inconsequential way.
pan: a container made of metal and used for cooking food in.
trumpet: a brass musical instrument with a flared bell and a bright, penetrating tone. The modern instrument has the tubing looped to form a straight-sided coil, with three valves.
prone: likely to or liable to suffer from, do, or experience something, typically something regrettable or unwelcome.
stimulate: encouragement of something to make it develop or become more active.
monetize: earn revenue from (an asset, business, etc.).
decree: an official order issued by a legal authority.
picnic: an outing or occasion that involves taking a packed meal to be eaten outdoors.
paratroopers: a member of a paratroop regiment or airborne unit.
bowl: a round, deep dish or basin used for food or liquid.
asphyxiate: kill (someone) by depriving them of air; suffocate; smother; choke; throttle; strangle; strangulate.
blockade: an act or means of sealing off a place to prevent goods or people from entering or leaving.
peel: remove the outer covering or skin from (a fruit or vegetable).
proselytize: convert or attempt to convert (someone) from one religion, belief, or opinion to another.
bobbed: (of hair) cut in a bob.
beret: a round flattish cap of felt or cloth.
soaked: extremely wet; saturated.
curfew: a regulation requiring people to remain indoors between specified hours, typically at night.
sanguine: optimistic or positive, especially in an apparently bad or difficult situation.
semiliterate: unable to read or write with ease or fluency; poorly educated.
expedite: make (an action or process) happen sooner or be accomplished more quickly.
stigma: a mark of disgrace associated with a particular circumstance, quality, or person.
infodemic: an excessive amount of information about a problem that is typically unreliable, spreads rapidly, and makes a solution more difficult to achieve.
enumerable: able to be counted by one-to-one correspondence with the set of all positive integers.
prejudice: preconceived opinion that is not based on reason or actual experience.
enhance: intensify, increase, or further improve the quality, value, or extent of.
bounce: (of an object, especially a ball) move quickly up, back, or away from a surface after hitting it; rebound (once or repeatedly).
oat: a cereal plant cultivated chiefly in cool climates and widely used for animal feed as well as human consumption.
mope: be dejected and apathetic.
dormitory: a large bedroom for ath effort or force.
overhaul: a thorough examination of number of people in a school or institution.
ostracize: exclude (someone) from a society or group.
haul: (of a person) pull or drag wi machinery or a system, with repairs or changes made if necessary.
detestable: deserving intense dislike.
acronym: an abbreviation formed from the initial letters of other words and pronounced as a word (e.g. ASCII, NASA ).
initialism: an abbreviation consisting of initial letters pronounced separately (e.g., CPU ).
despicable: deserving hatred and contempt.
pinch: grip (something, typically someone's flesh) tightly and sharply between finger and thumb.
veracity: conformity to facts; accuracy.
strait: a narrow passage of water connecting two seas or two other large areas of water.
raving: wild, irrational, or incoherent talk.
senile: (of a person) having or showing the weaknesses or diseases of old age, especially a loss of mental faculties.
leviathan: (in biblical use) a sea monster, identified in different passages with the whale and the crocodile (e.g. Job 41, Ps. 74:14), and with the Devil (after Isa. 27:1).
morph: to gradually change, or change someone or something, from one thing to another.
flee: run away from a place or situation of danger.
parlay: a series of two or more bets so set up in advance.
looming: appear as a shadowy form, especially one that is large or threatening.
eradicate: destroy completely; put an end to.
numerous: great in number; many.
shrouded: wrap or dress (a body) in a shroud for burial.
slay: to kill in a violent way.
dreadnought: a heavy overcoat for stormy weather.
erect: construct (a building, wall, or other upright structure).
vanguard: a group of people leading the way in new developments or ideas.
brood: a family of young animals, especially of a bird, produced at one hatching or birth.
hatch: (of an egg) open and produce a young animal.
wield: hold and use (a weapon or tool).
brethren: fellow Christians or members of a male religious order.
exodus: a mass departure of people, especially emigrants.
trek: go on a long arduous journey, typically on foot.
terraform: (especially in science fiction) transform (a planet) so as to resemble the earth, especially so that it can support human life.
radiance: light or heat as emitted or reflected by something.
ethos: the characteristic spirit of a culture, era, or community as manifested in its beliefs and aspirations.
myriad: a countless or extremely great number.
extinguish: cause (a fire or light) to cease to burn or shine.
cease: bring or come to an end.
notorious: famous or well known, typically for some bad quality or deed.
prefabricate: manufacture (a building or piece of furniture) in sections to enable quick or easy assembly on site.
vault: a type of arch that supports a roof or ceiling, especially in a church or public building, or a ceiling or roof supported by several of these arches.
petty: of little importance; trivial.
colonize: (of a country or its citizens) send a group of settlers to (a place) and establish political control over it.
fortify: provide (a place) with defensive works as protection against attack.
autonomous: (in Kantian moral philosophy) acting in accordance with one's moral duty rather than one's desires.
vail: take off or lower (one's hat or crown) as a token of respect or submission.
assailant: a person who physically attacks another.
tether: tie (an animal) with a rope or chain so as to restrict its movement.
hull: the main body of a ship or other vessel, including the bottom, sides, and deck but not the masts, superstructure, rigging, engines, and other fittings.
swirl: a quantity of something moving in a swirl.
inquire: ask for information from someone.
verdict: a decision on a disputed issue in a civil or criminal case or an inquest.
covenant: an agreement.
prosperous: successful in material terms; flourishing financially.
prosperity: the state of being prosperous.
deicide: the killer of a god.
whilst: (archaic) while.
monarchy: a form of government with a monarch at the head.
paracausal: category used to refer to abilities, events or entities which seem to violate causality.
stride: walk with long, decisive steps in a specified direction; tread; pace; step.
tramp: walk heavily or noisily.
missile: an object which is forcibly propelled at a target, either by hand or from a mechanical weapon.
nuke: attack or destroy with nuclear weapons.
supplant: supersede and replace.
enact: make (a bill or other proposal) law.
distributary: a branch of a river that does not return to the main stream after leaving it (as in a delta).
greet: give a polite word or sign of welcome or recognition to (someone) on meeting.
cosmodrome: (in the countries of the former Soviet Union) a launching site for spacecraft.
burrow: (of an animal) make a hole or tunnel, typically for use as a dwelling.
flock: congregate or mass in a flock or large group.
transgress: infringe or go beyond the bounds of (a moral principle or other established standard of behavior).
huddle: crowd together; nestle closely.
stupendous: extremely impressive.
televise: transmit by television.
scrim: strong, coarse fabric, chiefly used for heavy-duty lining or upholstery.
apportion: divide and allocate.
coarse: rough or loose in texture or grain.
sorority: a brotherhood or sisterhood formed around common goals and aspirations.
howl: make a howling sound.
fir: an evergreen coniferous tree with upright cones and flat needle-shaped leaves, typically arranged in two rows. Firs are an important source of timber and resins.
inscrutable: impossible to understand or interpret.
animosity: strong hostility.
plunder: steal goods from (a place or person), typically using force and in a time of war or civil disorder.
ferocious: savagely fierce, cruel, or violent.
venture: a risky or daring journey or undertaking.
skald: (in ancient Scandinavia) a composer and reciter of poems honoring heroes and their deeds.
compendium: a collection of concise but detailed information about a particular subject, especially in a book or other publication.
lament: a passionate expression of grief or sorrow.
slough: shed or remove (a layer of dead skin).
dynasty: a line of hereditary rulers of a country.
intact: not damaged or impaired in any way; complete.
triumph: a great victory or achievement.
vital: absolutely necessary or important; essential.
bulwark: a defensive wall.
terrestrial: of, on, or relating to the earth.
steadfast: resolutely or dutifully firm and unwavering.
mutable: liable to change.
impoverish: make (a person or area) poor.
sporadic: occurring at irregular intervals or only in a few places; scattered or isolated.
incendiary: (of a device or attack) designed to cause fires.
arbitrary: based on random choice or personal whim, rather than any reason or system.
misbehave: (of a person, especially a child) fail to conduct oneself in a way that is acceptable to others; behave badly.
censure: express severe disapproval of (someone or something), especially in a formal statement.
feign: pretend to be affected by (a feeling, state, or injury).
bereft: deprived of or lacking (something).
superfine: of especially high quality.
dictate: lay down authoritatively; prescribe.
matrimony: the state or ceremony of being married; marriage.
behalf: representing.
recitative: musical declamation of the kind usual in the narrative and dialogue parts of opera and oratorio, sung in the rhythm of ordinary speech with many words on the same note.
vulgar: lacking sophistication or good taste; unrefined.
farce: a comic dramatic work using buffoonery and horseplay and typically including crude characterization and ludicrously improbable situations.
edict: an official order or proclamation issued by a person in authority.
oblige: make (someone) legally or morally bound to an action or course of action.
contented: happy and at ease.
alienate: cause (someone) to feel isolated or estranged.
woe: great sorrow or distress.
inscribe: write or carve (words or symbols) on something, especially as a formal or permanent record.
cab: a taxicab.
tarmac: material used for surfacing roads or other outdoor areas, consisting of crushed rock mixed with tar.
tar: a dark, thick, flammable liquid distilled from wood or coal, consisting of a mixture of hydrocarbons, resins, alcohols, and other compounds. It is used in roadmaking and for coating and preserving timber.
ripe: (of fruit or grain) developed to the point of readiness for harvesting and eating.
immaculate: (especially of a person or their clothes) perfectly clean, neat, or tidy.
vitality: the state of being strong and active; energy.
affront: offend the modesty or values of.
renounce: formally declare one's abandonment of (a claim, right, or possession).
relinquish: voluntarily cease to keep or claim; give up.
sublime: of such excellence, grandeur, or beauty as to inspire great admiration or awe.
regal: very special and suitable for a king or queen.
breeze: a gentle wind.
overpass: a bridge by which a road or railroad passes over another.
endorphin: any of a group of hormones secreted within the brain and nervous system and having a number of physiological functions. They are peptides which activate the body's opiate receptors, causing an analgesic effect.
mangle: severely mutilate, disfigure, or damage by cutting, tearing, or crushing.
slovenly: (especially of a person or their appearance) messy and dirty.
frenetic: fast and energetic in a rather wild and uncontrolled way.
ignominious: deserving or causing public disgrace or shame.
omniscient: knowing everything.
vehemently: in a forceful, passionate, or intense manner; with great feeling.
outburst: a sudden release of strong emotion.
eject: force or throw (something) out, typically in a violent or sudden way.
revere: feel deep respect or admiration for (something).
morose: sullen and ill-tempered.
hover: remain in one place in the air.
mercenary: (of a person or their behavior) primarily concerned with making money at the expense of ethics.
stray: move away aimlessly from a group or from the right course or place.
tabulate: arrange (data) in tabular form.
masochist: a person who derives sexual gratification from their own pain or humiliation.
depot: a place for the storage of large quantities of equipment, food, or some other commodity.
blemish: a small mark or flaw which spoils the appearance of something.
modest: unassuming or moderate in the estimation of one's abilities or achievements.
banish: send (someone) away from a country or place as an official punishment.
laden: carrying or holding a lot of something.
enfeeble: deprive of strength.
shard: a piece of broken ceramic, metal, glass, or rock, typically having sharp edges.
goon: a silly, foolish, or eccentric person.
refine: remove impurities or unwanted elements from (a substance), typically as part of an industrial process; purify; clear.
demented: suffering from dementia.
capricious: given to sudden and unaccountable changes of mood or behavior.
detract: diminish the worth or value of (a quality or achievement); cause someone or something to be distracted or diverted from.
incision: a surgical cut made in skin or flesh.
abdominal: relating to the abdomen/belly.
enteric: relating to or occurring in the intestines; intestinal.
bemuse: to slightly confuse someone.
befuddle: to confuse someone.
raspy: of sound Rough, raw, especially used to describe vocal quality.
adrift: If a person is adrift, they do not have a clear purpose in life or know what they want to do.
aid: to help.
candidate: a person named as the recipient of a grant, conveyance, or annuity; nominee.
aloft: in the air or in a higher position.
dock: an area of water in a port that can be closed off and that is used for putting goods onto and taking them off ships or repairing ships
Usury: the activity of lending someone money with the agreement that they will pay back a very much larger amount of money later; 
swill: to cause a liquid to flow around or over something, often in order to clean it.
tacit: understood without being expressed directly.
hurdle: one of a series of upright frames over which athletes in a race must jump.
poignant: causing or having a very sharp feeling of sadness; touching.
germane: Ideas or information that is germane to a particular subject or situation is connected with and important to it.
intrinsic: being an extremely important and basic characteristic of a person or thing.
pompous: too serious and full of importance.
gestalt: something such as a structure or experience that, when considered as a whole, has qualities that are more than the total of all its parts.
jaded: not having interest or losing interest because you have experienced something too many times; nonchalant; apathetic.
garrulous: having the habit of talking a lot, especially about things that are not important.
plausible: seeming likely to be true, or able to be believed; believable.
gist: the most important pieces of information about something, or general information without details; general information.
voluble: speaking a lot, with confidence and enthusiasm; talkative.
loquacious: Someone who is loquacious talks a lot; chatty.
fluorescent: Fluorescent lights are very bright, tube-shaped electric lights, often used in offices.
meticulous: showing great attention to detail; very careful and precise.
extemporize: compose, perform, or produce something such as music or a speech without preparation; improvise.
surly: often in a bad mood, unfriendly, and not polite.
petulant: easily annoyed and complaining in a rude way like a child.
amorous: showing, feeling, or relating to sexual desire.
surfeit: an amount that is too large, or is more than is needed.
sobriquet: a person's nickname.
aggregate: something formed by adding together several amounts or things.
milieu: the people, physical, and social conditions and events that provide the environment in which someone acts or lives
penchant: a strong or habitual liking for something or tendency to do something.
fruition: an occasion when a plan or an idea begins to happen, exist, or be successful
shriek: a short, loud, high cry, especially one produced suddenly as an expression of a powerful emotion.
pernicious: having a very harmful effect or influence.
strive: persue; endeavor.
defy: to refuse to obey a person, decision, law, situation, etc.
presumptuous: A person who is presumptuous shows little respect for others by doing things they have no right to do; cheeky; impudent.
devise: to invent a plan, system, object, etc., usually using your intelligence or imagination
monumental: very big.
preposterous: contrary to reason or common sense; utterly absurd or ridiculous.
sniff: inhale.
commomorate: to remember officially and give respect to a great person or event, especially by a public ceremony or by making a statue or special building.
aver: to say that something is certainly true; affirm
ascertain: to discover something or to make certain of something.
repent: to be very sorry for something bad you have done in the past and wish that you had not done it.
tumble: to fall quickly and without control; stumble.
tarnish: to make or (especially of metal) become less bright or a different colour.
juxtapose: to put things that are not similar next to each other; appose.
vicinity: the area near or surrounding a particular place.
grotesque: comically or repulsively ugly or distorted.
embellish: make (a statement or story) more interesting by adding extra details that are often untrue.
excoriate: criticize (someone) severely.
infuse: fill; pervade.
condiment: a substance, such as salt, that you add to food to improve its taste.
literate: having knowledge of a particular subject, or a particular type of knowledge; acumen.
illterate: Antonymous of literate.
edify: to improve someone's mind.
destitute: without money, food, a home, or possessions.
permeate: to spread through something and be present in every part of it.
attenuate: to make something less or weaker; weaken.
compulsory: If something is compulsory, you must do it because of a rule or law.
assuage: to make unpleasant feelings less strong.
apoplectic: extremely and obviously angry.
disposition: the particular type of character that a person naturally has.
concurrent: happening or existing at the same time.
distraught: extremely worried, nervous, or upset.
prorated: calculated according to the amount of something that has been used, in relation to a larger total amount.
idempotent: denoting an element of a set which is unchanged in value when multiplied or otherwise operated on by itself.
insolent: rude and not showing respect.
procure: to get something, especially after an effort.
infirmity: illness, especially for long periods or because of old age.
fondly: in a way that shows love or great liking.
verbose: the quality of being verbose (using too many words).
arcane: mysterious and known only by a few people.
antecedent: someone or something existing or happening before, especially as the cause or origin of something existing or happening later.
abscond: to go away suddenly and secretly in order to escape from somewhere; flee.
demeanor: a way of looking and behaving.
commensurate: in a correct and suitable amount compared to something else.
morbid: too interested in unpleasant subjects, especially death.
cogent: A cogent argument, reason, etc. is clearly expressed and persuades people to believe it.
deluge: a very large amount of rain or water.
denigrate: to say that someone or something is not good or important.
crepuscular: relating to or like the time of day just before the sun goes down, when the light is not bright.
clinch: the position two people are in when they are holding each other tightly in their arms, when fighting or showing love.
ladle: a very big spoon with a long handle and a deep cup-shaped part, used especially for serving soup.
defame: to damage the reputation of a person or group by saying or writing bad things about them that are not true.
besmirch: to say bad things about someone to influence other people's opinion of them.
slander: a false spoken statement about someone that damages their reputation, or the making of such a statement.
assimilable: that can be understood, learned, or remembered.
axiomatic: obviously true and therefore not needing to be proved.
extant: used to refer to something very old that is still existing.
inexorable: continuing without any possibility of being stopped; unstoppable.
reproach: to tell someone that they have done something wrong.
pioneer: to be one of the first people to do something; actualize
smudgy: (of a mark, etc.) having no particular shape, or without clear edges.
tumult: a loud noise, especially that produced by an excited crowd, or a state of confusion, change, or uncertainty.
mollify: to make someone less angry or upset.
appease: to prevent further disagreement in arguments or war by giving to the opposing side an advantage that they have demanded.
propitiate: to please and make calm a god or person who is annoyed with you.
conciliate: to end a disagreement or someone's anger by acting in a friendly way or slightly changing your opinions, or to satisfy someone who disagrees with you by acting in this way.
liaise: to speak to people in other organizations, etc. in order to work with them or exchange information with them.
pendent: hanging from or over something.
dangle: to hang loosely, or to hold something so that it hangs loosely; to offer someone something that they want in order to persuade that person to do something.
customary: usual.
accustom: to make someone familiar with new conditions.
omnipotence: unlimited power and the ability to do anything.
amid: in the middle of or surrounded by; midst.
vacuous: not expressing or showing intelligent thought or purpose; asinine; foolish; stupid; idiotic.
hiatus: a pause or break in continuity in a sequence or activity.
relent: to act in a less severe way towards someone and allow something that you had refused to allow before.
artifice: (the use of) a clever trick or something intended to deceive
pejorative: expressing disapproval, or suggesting that something is not good or is of no importance.
contempt: a strong feeling of disliking and having no respect for someone or something.
abominate: to hate something very much.
vacate: to leave a room, building, chair, etc. so that it is available for other people.
vamoose: (informal) to go away or disappear.
absquatulate: to leave suddenly.
scarce: not easy to find or get.
abundant: more than enough; ample; plentiful.
inordinate: much more than usual or expected.
abase: to make someone or something seem to be less important or to not deserve respect.
forgo: to give up or do without.
abstain: to not do something, especially something enjoyable that you think might be bad.
predominantly: mostly or mainly; preponderantly.
deter: discourage (someone) from doing something by instilling doubt or fear of the consequences.
vindicate: to prove that what someone said or did was right or true, after other people thought it was wrong; attest.
concert: (verb) arrange (something) by mutual agreement or coordination.
proclivity: the fact that someone likes something or likes to do something, especially something considered morally wrong.
corroborate: to add proof to an account, statement, idea, etc. with new information.
pall: to become less interesting or enjoyable.
expariate: to move from your own country, or to cause someone to move from their own country; banish; deport; exile; expel.
contagious: A contagious disease can be caught by touching someone who has the disease or a piece of infected clothing; infectious.